000000000000000000000000000000
000000000000000000000000000000
001110000000000000010000011100
001000000000000000011000000100
001000000000000000001000000100
000000000000111100001000000000
000000000000000000000000000000
000000000000000000000000000000
000000010000000000000000000000
000000010000000000000000000000
000000010000000111000000000000
000000010000000000001000000000
000000010001000000001000000000
000000000001000000001000000000
000000000000000000000000000000
000001000000000000001000111000
000000000000000000001000000000
000000000000011000001000000000
010000000000000000000000000000
010000000000000001001000000000
000000011110000001001000000000
000000000000000001001000000000
000000000000000000000000000000
000000000000000000000000000000
000000111110000000000000001000
000000000000000000000000001000
000000000000000000000000111000
001100000000000001111000000000
000000000000000000000000000000
000000000000000000000000000000